aštuoni	A S2 T U O_ N I
aštuoniolika	A S2 T U O_ N IO_ L I K A
devyni	D E V I_ N I
devyniolika	D E V I_ N IO_ L I K A
dešimt	D E S2 I M T
du	D U
dvidešimt	D V I D E S2 I M T
dvylika	D V I_ L I K A
keturi	K E T U R I
keturiolika	K E T U R IO_ L I K A
penki	P E N K I
penkiolika	P E N K IO_ L I K A
septyni	S E P T I_ N I
septyniolika	S E P T I_ N IO_ L I K A
trylika	T R I_ L I K A
trys	T R I_ S
vienas	V I E N A S
vienuolika	V I E N U O_ L I K A
šeši	S2 E S2 I
šešiolika	S2 E S2 IO_ L I K A
